W W W W W W W W W W W W W W W W W W
W D D D D D D D D D D D D D D D D W
W D B D D D D D D D D D D D D D P W
W D D G D D B B B D D G D D D D D W
W D B D D D D D D D D D D B D D D W
W D D D D D D D D D D D D D D B D W
W D D B D D D G D D D D D D D D D W
W D D D D D B D D D D D D D D G D W
W D D D D D D D D D D D D B D D D W
W D D D D D D D D G D D D D D D D W
W W W W W W W W W W W W W W W W W W
