W W W W W W W W W W W W W W W W W W
W D B D D D D D D D D D D D D D D W
W D D D D D B D B G D D B D B D D W
W D G D D D D D D D D D D B D G D W
W D D D D D D D D D D D D D D D D W
W D B D D D B B B D D G D B D D D W
W D D D D D D D D D D D D D D D D W
W D B D D P B B B D B D D D D B D W
W D D D G D D D D D D D D D D D D W
W D D D D D D D D D D B D D D D D W
W W W W W W W W W W W W W W W W W W
