W W W W W W W W W W W W W W W W W W
W D D D D D B D D G D D D D B D D W
W D P D D B D D D D D D D D D B D W
W D D D B D D D D D D B D D D G B W
W D B D D D D D D B D D B D D D B W
W G B D D D G D B B D D D D D D B W
W D B D B D D D D D D D D D D B D W
W D D D D B D D D D B D D D B D D W
W D D D D D B D D D D B D D G D D W
W D D D D B D D D D D D D D D D D W
W W W W W W W W W W W W W W W W W W
