W W W W W W W W W W W W W W W W W W
W D D D D D D D D D D D D D D D D W
W D D D D D D D G D D D D D D D D W
W D D D B D B D D D D B B D D D D W
W D D D D D B D D D D D D D D D D W
W D P D D D B D D D D D D D D D D W
W D D D D D D D B D D D D G D B D W
W D D D D G D D G D D B D D D D D W
W D D D D D D D D D D D D D D D D W
W D D D D D D D D D D D D D D G D W
W W W W W W W W W W W W W W W W W W
