W W W W W W W W W W W W W W W W W W
W D D D D D D D D B D D D D D D D W
W D D D D D B G B D G B D D D D D W
W D B D D D D D D D B D G D D D D W
W D D D D D D D D D D B B D B D D W
W D D D D D D D D D D D D D D D D W
W D G D B D D D D D D D D D D D B W
W D D D D D D D B D D D D P D B G W
W D D D D D D B D D D D D D D D D W
W D D D D D D D D D D D D D D D D W
W W W W W W W W W W W W W W W W W W
